"a" = (/turf/space,/area)
"b" = (/turf/simulated/wall,/area)
"c" = (/obj/structure/closet/secure_closet/freezer/fridge,/turf/simulated/floor{icon_state = "freezerfloor"},/area)
"d" = (/obj/structure/closet/secure_closet/freezer/meat,/turf/simulated/floor{icon_state = "freezerfloor"},/area)
"e" = (/turf/simulated/floor{icon_state = "freezerfloor"},/area)
"f" = (/obj/machinery/cooking/candy,/turf/simulated/floor{icon_state = "freezerfloor"},/area)
"g" = (/obj/machinery/cooking,/turf/simulated/floor{icon_state = "freezerfloor"},/area)
"h" = (/obj/machinery/cooking/cerealmaker,/turf/simulated/floor{icon_state = "freezerfloor"},/area)
"i" = (/obj/machinery/cooking/deepfryer,/turf/simulated/floor{icon_state = "freezerfloor"},/area)
"j" = (/obj/machinery/cooking/grill,/turf/simulated/floor{icon_state = "freezerfloor"},/area)
"k" = (/obj/item/weapon/reagent_containers/food/snacks/badrecipe,/obj/item/weapon/reagent_containers/food/snacks/baguette,/turf/simulated/floor{icon_state = "freezerfloor"},/area)
"l" = (/mob/living/simple_animal/hostile/monster/cyber_horror{name = "Mr. Handy"},/turf/simulated/floor{icon_state = "freezerfloor"},/area)
"m" = (/obj/item/weapon/reagent_containers/food/snacks/badrecipe,/turf/simulated/floor{icon_state = "freezerfloor"},/area)
"n" = (/obj/structure/table/reinforced,/obj/structure/window/reinforced,/obj/structure/window/barricade/full,/turf/simulated/floor{icon_state = "freezerfloor"},/area)
"o" = (/obj/structure/table/reinforced,/obj/structure/window/barricade/full,/turf/simulated/floor{icon_state = "freezerfloor"},/area)
"p" = (/obj/structure/table/reinforced,/obj/structure/window/reinforced,/obj/item/weapon/reagent_containers/food/snacks/birthdaycakeslice,/turf/simulated/floor{icon_state = "freezerfloor"},/area)
"q" = (/obj/machinery/door/airlock/silver{name = "Kitchen"},/obj/structure/window/barricade/full/block,/turf/simulated/floor{icon_state = "freezerfloor"},/area)
"r" = (/turf/simulated/floor/beach/water,/area)
"s" = (/obj/structure/table,/turf/simulated/floor/beach/sand,/area)
"t" = (/obj/structure/window/barricade{dir = 1},/turf/simulated/floor/wood,/area)
"u" = (/turf/simulated/floor/wood,/area)
"v" = (/turf/simulated/floor/beach/sand,/area)
"w" = (/obj/structure/window/reinforced{dir = 1},/obj/structure/window/reinforced{dir = 4},/obj/structure/window/reinforced{dir = 8},/obj/structure/grille,/turf/simulated,/area)
"x" = (/obj/structure/bed/chair{dir = 4},/turf/simulated/floor/wood,/area)
"y" = (/obj/structure/table/woodentable,/turf/simulated/floor/wood,/area)
"z" = (/obj/structure/bed/chair{dir = 8},/turf/simulated/floor/wood,/area)
"A" = (/obj/structure/window/reinforced,/obj/structure/window/reinforced{dir = 4},/obj/structure/window/reinforced{dir = 8},/obj/structure/grille,/turf/simulated,/area)
"B" = (/obj/structure/table/woodentable,/obj/item/weapon/reagent_containers/food/snacks/meat/roach,/turf/simulated/floor/wood,/area)
"C" = (/obj/structure/window/reinforced{dir = 4},/obj/structure/window/reinforced{dir = 8},/obj/structure/grille,/turf/simulated,/area)
"D" = (/obj/structure/table/woodentable,/obj/item/weapon/reagent_containers/food/snacks/grilledcheese,/turf/simulated/floor/wood,/area)
"E" = (/obj/machinery/door/airlock/external,/turf/simulated/floor/wood,/area)

(1,1,1) = {"
aaaaaaaaaaaaaaaaaaaaaaaaa
aaaaaaaaaaaaaaaaaaaaaaaaa
aaaaaaaaaaaaaaaaaaaaaaaaa
aaaaaaaaaaaaaaaaaaaaaaaaa
aaaaaaaaaaaaaaaaaaaaaaaaa
aaaaaaaaaaaaaaaaaaaaaaaaa
aaaaaaaaaaaaaaaaaaaaaaaaa
aaaaaaaaaaaaaaaaaaaaaaaaa
aaaaaabbbbbbbbbbbbaaaaaaa
aaaaaabcdefghiijjbaaaaaaa
aaaaaabekeeleeeeebaaaaaaa
aaaaaabemeeeeeeeebaaaaaaa
aaaaaabbbbnopbbqbbaaaaaaa
aaaaaabrsbttttuuubaaaaaaa
aaaaaabvvbuuuuuuuwaaaaaaa
aaaaaabvvbxyzuxyzAaaaaaaa
aaaaaabubbxyzuxBzbaaaaaaa
aaaaaabuuuuuuuuuubaaaaaaa
aaaaaawuuuuuuuuuuwaaaaaaa
aaaaaaCuuuxDzuxyzCaaaaaaa
aaaaaaAuuuxyzuxyzAaaaaaaa
aaaaaabuuuuuuuuuubaaaaaaa
aaaaaabuuuuuuuuuubaaaaaaa
aaaaaabbbbbbbEbbbbaaaaaaa
aaaaaaaaaaaaaaaaaaaaaaaaa
"}
